#####E#
#.#.#.#
#.....#
##.####
#....S#
#.#..##
#######