#####E####
#...#....#
#.######.#
#.#T.....#
#.###.####
#....S...#
#####.##.#
#..##.####
##....T..#
##########