###E###########
#........###..#
########.....##
#.....##.###.##
#.###.....##..#
#.....###...###
####.####.#.###
##......#.....#
#######.#.###.#
#.........#####
#.####.S#....##
##....#.#######
#..##.........#
##..T###.##.###
###############