#####E####
#...#....#
#.######.#
#.#......#
#.###.####
#....S...#
#####.##.#
#..##.####
##.......#
##########