####################
#..................#
#.##############.###
#.########.......###
#.#........######..#
#.##.##.##........##
#.#...#.##.######.##
#.###.#.##.....##.##
#.###..##########.##
#.####.###.........#
#.#....#...####.####
#.#.####.####.....##
#.#......#......####
#.###.####.#####...#
#.#......#.....#.###
#.######...#####.#.#
#.#.....##S....#.#.#
#.#########..#.....#
#..........###.##.##
##########E#########