####E######
##...#.####
#..#.#.####
#.##...####
#.##.#..S##
###########