##########
#S.......#
########.#
#........#
#.########
#........#
########.#
#........#
#.########
#E########