##################
##...#####...#####
##.#.##....#.....#
##.S....##...###.#
###.####.#.#.....#
#........#.##.####
##.#######......##
##......##########
#####.####....##.#
##.........##..#.#
#######.#####.##.#
####.##.##T....#.#
####.##.########.#
#................#
#..###############
##.#.##.#.##.##.##
##...............#
##########E#######