#####E#
#.#.#.#
#.....#
##.####
#....S#
#T#..##
#######