##########
#S.......#
########.#
#..T.....#
#.########
#........#
########.#
#..T.....#
#.########
#E########