###E###########
#........###..#
########.....##
#..T..##.###.##
#.###.....##..#
#.....###...###
####.####.#.###
##......#.....#
#######.#.###.#
#.........#####
#.####.S#....##
##....#.#######
#..##T........#
##...###.##.###
###############