####################
#..................#
#.##############.###
#.########.......###
#.#.T......######..#
#.##.##.##........##
#.#...#.##.######.##
#.###.#.##....T##.##
#.###..##########.##
#.####.###.........#
#.#....#...####.####
#.#.####.####.....##
#.#......#......####
#.###.####.#####...#
#.#T.....#.....#.###
#.######...#####.#.#
#.#.....##S....#.#.#
#.#########..#...T.#
#..........###.##.##
##########E#########